"filename", "language", "SCSS", "TypeScript", "HTML", "CSS", "comment", "blank", "total"
"/home/bojan/codeStuff/MATURSKI2.0/frontend/HaveFun/src/app/app-routing.module.ts", "TypeScript", 0, 18, 0, 0, 0, 4, 22
"/home/bojan/codeStuff/MATURSKI2.0/frontend/HaveFun/src/app/app.component.html", "HTML", 0, 0, 9, 0, 0, 0, 9
"/home/bojan/codeStuff/MATURSKI2.0/frontend/HaveFun/src/app/app.component.scss", "SCSS", 0, 0, 0, 0, 0, 1, 1
"/home/bojan/codeStuff/MATURSKI2.0/frontend/HaveFun/src/app/app.component.spec.ts", "TypeScript", 0, 21, 0, 0, 0, 3, 24
"/home/bojan/codeStuff/MATURSKI2.0/frontend/HaveFun/src/app/app.component.ts", "TypeScript", 0, 31, 0, 0, 0, 5, 36
"/home/bojan/codeStuff/MATURSKI2.0/frontend/HaveFun/src/app/app.module.ts", "TypeScript", 0, 24, 0, 0, 0, 3, 27
"/home/bojan/codeStuff/MATURSKI2.0/frontend/HaveFun/src/app/auth/auth-guard-online.service.ts", "TypeScript", 0, 27, 0, 0, 0, 6, 33
"/home/bojan/codeStuff/MATURSKI2.0/frontend/HaveFun/src/app/auth/auth.component.html", "HTML", 0, 0, 28, 0, 0, 0, 28
"/home/bojan/codeStuff/MATURSKI2.0/frontend/HaveFun/src/app/auth/auth.component.scss", "SCSS", 0, 0, 0, 0, 0, 1, 1
"/home/bojan/codeStuff/MATURSKI2.0/frontend/HaveFun/src/app/auth/auth.component.spec.ts", "TypeScript", 0, 20, 0, 0, 0, 6, 26
"/home/bojan/codeStuff/MATURSKI2.0/frontend/HaveFun/src/app/auth/auth.component.ts", "TypeScript", 0, 11, 0, 0, 0, 6, 17
"/home/bojan/codeStuff/MATURSKI2.0/frontend/HaveFun/src/app/auth/auth.module.ts", "TypeScript", 0, 29, 0, 0, 0, 4, 33
"/home/bojan/codeStuff/MATURSKI2.0/frontend/HaveFun/src/app/auth/auth.router.module.ts", "TypeScript", 0, 26, 0, 0, 0, 4, 30
"/home/bojan/codeStuff/MATURSKI2.0/frontend/HaveFun/src/app/auth/auth.service.ts", "TypeScript", 0, 266, 0, 0, 19, 34, 319
"/home/bojan/codeStuff/MATURSKI2.0/frontend/HaveFun/src/app/auth/authentification/authentification.component.html", "HTML", 0, 0, 242, 0, 14, 13, 269
"/home/bojan/codeStuff/MATURSKI2.0/frontend/HaveFun/src/app/auth/authentification/authentification.component.scss", "SCSS", 19, 0, 0, 0, 0, 5, 24
"/home/bojan/codeStuff/MATURSKI2.0/frontend/HaveFun/src/app/auth/authentification/authentification.component.ts", "TypeScript", 0, 144, 0, 0, 18, 34, 196
"/home/bojan/codeStuff/MATURSKI2.0/frontend/HaveFun/src/app/auth/forgotpassword/forgotpassword.component.html", "HTML", 0, 0, 85, 0, 0, 2, 87
"/home/bojan/codeStuff/MATURSKI2.0/frontend/HaveFun/src/app/auth/forgotpassword/forgotpassword.component.scss", "SCSS", 10, 0, 0, 0, 0, 3, 13
"/home/bojan/codeStuff/MATURSKI2.0/frontend/HaveFun/src/app/auth/forgotpassword/forgotpassword.component.spec.ts", "TypeScript", 0, 20, 0, 0, 0, 6, 26
"/home/bojan/codeStuff/MATURSKI2.0/frontend/HaveFun/src/app/auth/forgotpassword/forgotpassword.component.ts", "TypeScript", 0, 84, 0, 0, 2, 18, 104
"/home/bojan/codeStuff/MATURSKI2.0/frontend/HaveFun/src/app/auth/profile/profile.component.html", "HTML", 0, 0, 215, 0, 4, 4, 223
"/home/bojan/codeStuff/MATURSKI2.0/frontend/HaveFun/src/app/auth/profile/profile.component.scss", "SCSS", 20, 0, 0, 0, 0, 6, 26
"/home/bojan/codeStuff/MATURSKI2.0/frontend/HaveFun/src/app/auth/profile/profile.component.ts", "TypeScript", 0, 114, 0, 0, 0, 20, 134
"/home/bojan/codeStuff/MATURSKI2.0/frontend/HaveFun/src/app/auth/profileImage.model.ts", "TypeScript", 0, 5, 0, 0, 0, 1, 6
"/home/bojan/codeStuff/MATURSKI2.0/frontend/HaveFun/src/app/auth/signupwelcome-interceptor.service.ts", "TypeScript", 0, 22, 0, 0, 0, 4, 26
"/home/bojan/codeStuff/MATURSKI2.0/frontend/HaveFun/src/app/auth/signupwelcome/signupwelcome.component.html", "HTML", 0, 0, 24, 0, 0, 1, 25
"/home/bojan/codeStuff/MATURSKI2.0/frontend/HaveFun/src/app/auth/signupwelcome/signupwelcome.component.scss", "SCSS", 3, 0, 0, 0, 0, 0, 3
"/home/bojan/codeStuff/MATURSKI2.0/frontend/HaveFun/src/app/auth/signupwelcome/signupwelcome.component.ts", "TypeScript", 0, 36, 0, 0, 0, 4, 40
"/home/bojan/codeStuff/MATURSKI2.0/frontend/HaveFun/src/app/auth/user.model.ts", "TypeScript", 0, 10, 0, 0, 0, 2, 12
"/home/bojan/codeStuff/MATURSKI2.0/frontend/HaveFun/src/app/header/header.component.html", "HTML", 0, 0, 84, 0, 47, 10, 141
"/home/bojan/codeStuff/MATURSKI2.0/frontend/HaveFun/src/app/header/header.component.scss", "SCSS", 17, 0, 0, 0, 0, 3, 20
"/home/bojan/codeStuff/MATURSKI2.0/frontend/HaveFun/src/app/header/header.component.spec.ts", "TypeScript", 0, 20, 0, 0, 0, 6, 26
"/home/bojan/codeStuff/MATURSKI2.0/frontend/HaveFun/src/app/header/header.component.ts", "TypeScript", 0, 42, 0, 0, 1, 7, 50
"/home/bojan/codeStuff/MATURSKI2.0/frontend/HaveFun/src/app/posts/fresh/fresh.component.html", "HTML", 0, 0, 28, 0, 0, 1, 29
"/home/bojan/codeStuff/MATURSKI2.0/frontend/HaveFun/src/app/posts/fresh/fresh.component.scss", "SCSS", 8, 0, 0, 0, 0, 1, 9
"/home/bojan/codeStuff/MATURSKI2.0/frontend/HaveFun/src/app/posts/fresh/fresh.component.spec.ts", "TypeScript", 0, 20, 0, 0, 0, 6, 26
"/home/bojan/codeStuff/MATURSKI2.0/frontend/HaveFun/src/app/posts/fresh/fresh.component.ts", "TypeScript", 0, 86, 0, 0, 3, 17, 106
"/home/bojan/codeStuff/MATURSKI2.0/frontend/HaveFun/src/app/posts/fresh/freshComments/freshComment.component.html", "HTML", 0, 0, 0, 0, 0, 1, 1
"/home/bojan/codeStuff/MATURSKI2.0/frontend/HaveFun/src/app/posts/fresh/freshComments/freshComment.component.scss", "SCSS", 0, 0, 0, 0, 0, 1, 1
"/home/bojan/codeStuff/MATURSKI2.0/frontend/HaveFun/src/app/posts/fresh/freshComments/freshComment.component.ts", "TypeScript", 0, 8, 0, 0, 0, 3, 11
"/home/bojan/codeStuff/MATURSKI2.0/frontend/HaveFun/src/app/posts/image.model.ts", "TypeScript", 0, 13, 0, 0, 0, 1, 14
"/home/bojan/codeStuff/MATURSKI2.0/frontend/HaveFun/src/app/posts/new/new.component.html", "HTML", 0, 0, 52, 0, 2, 5, 59
"/home/bojan/codeStuff/MATURSKI2.0/frontend/HaveFun/src/app/posts/new/new.component.scss", "SCSS", 10, 0, 0, 0, 3, 6, 19
"/home/bojan/codeStuff/MATURSKI2.0/frontend/HaveFun/src/app/posts/new/new.component.ts", "TypeScript", 0, 47, 0, 0, 19, 16, 82
"/home/bojan/codeStuff/MATURSKI2.0/frontend/HaveFun/src/app/posts/popular/popular.component.html", "HTML", 0, 0, 1, 0, 0, 1, 2
"/home/bojan/codeStuff/MATURSKI2.0/frontend/HaveFun/src/app/posts/popular/popular.component.scss", "SCSS", 0, 0, 0, 0, 0, 1, 1
"/home/bojan/codeStuff/MATURSKI2.0/frontend/HaveFun/src/app/posts/popular/popular.component.spec.ts", "TypeScript", 0, 20, 0, 0, 0, 6, 26
"/home/bojan/codeStuff/MATURSKI2.0/frontend/HaveFun/src/app/posts/popular/popular.component.ts", "TypeScript", 0, 11, 0, 0, 0, 5, 16
"/home/bojan/codeStuff/MATURSKI2.0/frontend/HaveFun/src/app/posts/post.model.ts", "TypeScript", 0, 31, 0, 0, 0, 3, 34
"/home/bojan/codeStuff/MATURSKI2.0/frontend/HaveFun/src/app/posts/posts.component.html", "HTML", 0, 0, 1, 0, 27, 0, 28
"/home/bojan/codeStuff/MATURSKI2.0/frontend/HaveFun/src/app/posts/posts.component.scss", "SCSS", 0, 0, 0, 0, 0, 1, 1
"/home/bojan/codeStuff/MATURSKI2.0/frontend/HaveFun/src/app/posts/posts.component.spec.ts", "TypeScript", 0, 20, 0, 0, 0, 6, 26
"/home/bojan/codeStuff/MATURSKI2.0/frontend/HaveFun/src/app/posts/posts.component.ts", "TypeScript", 0, 12, 0, 0, 0, 6, 18
"/home/bojan/codeStuff/MATURSKI2.0/frontend/HaveFun/src/app/posts/posts.module.ts", "TypeScript", 0, 33, 0, 0, 0, 5, 38
"/home/bojan/codeStuff/MATURSKI2.0/frontend/HaveFun/src/app/posts/posts.router.module.ts", "TypeScript", 0, 24, 0, 0, 0, 5, 29
"/home/bojan/codeStuff/MATURSKI2.0/frontend/HaveFun/src/app/posts/posts.service.ts", "TypeScript", 0, 74, 0, 0, 21, 20, 115
"/home/bojan/codeStuff/MATURSKI2.0/frontend/HaveFun/src/app/posts/trending/trending.component.html", "HTML", 0, 0, 1, 0, 0, 1, 2
"/home/bojan/codeStuff/MATURSKI2.0/frontend/HaveFun/src/app/posts/trending/trending.component.scss", "SCSS", 0, 0, 0, 0, 0, 1, 1
"/home/bojan/codeStuff/MATURSKI2.0/frontend/HaveFun/src/app/posts/trending/trending.component.spec.ts", "TypeScript", 0, 20, 0, 0, 0, 6, 26
"/home/bojan/codeStuff/MATURSKI2.0/frontend/HaveFun/src/app/posts/trending/trending.component.ts", "TypeScript", 0, 12, 0, 0, 0, 5, 17
"/home/bojan/codeStuff/MATURSKI2.0/frontend/HaveFun/src/app/posts/whoUpvoted.model.ts", "TypeScript", 0, 7, 0, 0, 0, 1, 8
"/home/bojan/codeStuff/MATURSKI2.0/frontend/HaveFun/src/app/shared/confirmEqualValidator.directive.ts", "TypeScript", 0, 20, 0, 0, 1, 4, 25
"/home/bojan/codeStuff/MATURSKI2.0/frontend/HaveFun/src/app/shared/loading-spiner/loading-spinner.component.css", "CSS", 0, 0, 0, 84, 0, 0, 84
"/home/bojan/codeStuff/MATURSKI2.0/frontend/HaveFun/src/app/shared/loading-spiner/loading-spinner.component.ts", "TypeScript", 0, 8, 0, 0, 0, 4, 12
"/home/bojan/codeStuff/MATURSKI2.0/frontend/HaveFun/src/app/shared/shared.module.ts", "TypeScript", 0, 20, 0, 0, 0, 6, 26
"Total", "-", 87, 1456, 770, 84, 181, 371, 2949